WWWWWWWWWWWWWWWWWWWWWWWWWWWWWWWWWWWWWWWWWWWWWWWWW
W P    W                                        W
W      WWWWWWW                                  W
W      W      W           WW     WWWW           W
W      W       W      W                         W
W      W       W      W                         W
W      W       W    WWWWWW     WW               W
W      W       W      W                         W
W      W       W      W                         W
W      W        W     WWW      WWWW             W
W      W         W    W                         W
W      W    WW        W              W          W
W      WWWWW         WWW            WW          W  
W                   WWWWW          WWW          W  
W            W     W                            W  
W         WWWW    WW         WWWW               W  
W                 WW   W                        W 
W                 WW   W             W          W
W               WWWW     WWWWWW     W           W
W                                  W            W
W                                 W             W
W                                W              W
W                               W               W
W                              W                W
W                             W                 W
W                            W                  W
W                           W                   W
W                          W                    W
W                         W                     W
W                        W                      W
W                       W                       W
W                      W                        W
W                     W                         W
W                    W                          W
W                   W                           W
W                  W                            W
W                 W                             W
W                W                              W
W                                               W
WWWWWWWWWWWWWWWWWWWWWWWWWWWWWWWWWWWWWWWWWWWWWWWWW
