BBBBBBBBBBBBBBBBBBBBBBBBBBBBBBBBBBBBBBBBBBBBBBBBB
B P    B                                        B
B      BBBBBBB                                  B
B      B      B           BB     BBBB           B
B      B       B      B                         B
B      B       B      B                         B
B      B       B    BBBBBB     BB               B
B      B       B      B                         B
B      B       B      B                         B
B      B        B     BBB      BBBB             B
B      B         B    B                         B
B      B    BB        B              B          B
B      BBBBB         BBB            BB          B  
B                   BBBBB          BBB          B  
B            B     B                            B  
B         BBBB    BB         BBBB               B  
B                 BB   B                        B 
B                 BB   B             B          B
B               BBBB     BBBBBB     B           B
B                                  B            B
B                                 B             B
B                                B              B
B                               B               B
B                              B                B
B                             B                 B
B                            B                  B
B                           B                   B
B                          B                    B
B                         B                     B
B                        B                      B
B                       B                       B
B                      B                        B
B                     B                         B
B                    B                          B
B                   B                           B
B                  B                            B
B                 B                             B
B                B                              B
B                                               B
BBBBBBBBBBBBBBBBBBBBBBBBBBBBBBBBBBBBBBBBBBBBBBBBB
